OOOOOOOOOOOOOOOOOOOOOOOOOOOOOOOOOOOOOOOOOOOOOOOOOOOOOOOOOOOO
OLLOOOOLOOOOOOOOOOOLLOOOOOOOOOOOOOOOOOOOOOOOOOOOOOOOOOOOOOOO
OOOOOOOOGCOOOOOOOOOOOOOOOOOOOOOOOOOOOOOOOOOOOOOOOOOOOOOOOOOO
OXXOOOOXXXOOLOOOOOOXXXOLOOOOOOOOOOOOOOOOOOOOOOOOOOOOOOOOOOOO
OXXOPOOOOOOOOOOOOOOOOOOOOOOOOXXXOOOOOOOLOOLOOOOOOOOOOOOOOOOO
OXXXXOOOOOOXXOOOOOOOOOOXXOOOOOLOOOOOOOOOCCOOOOOOOOOOOOOLLOOO
OXXXXOOOOOOXXOOOOOOOOOOCCOOOOOOCCOOOOOOXXXXOOOOOOOOOOGGOOOOO
OOOOOOOXOOOXXXXOOOOXXOOXXOOOOOXXXXOOOOOOOOOOOOXOOOOOXXXXXXOO
OCGGCOXXOOOXXXXOOOOXXOOXXOOOOOXXXXOOOOOOOOOOOOXOOOOXXXXXXXOO
XXXXXXXXOOXXXXXXOOXXXOXXXXOOOOXXXXOOOOOOOOOOOOXOOOOXXXXXXXOO
XXXXXXXXOOXXXXXXOOXXXOXXXXOOOOXXXXOOOOOOOOOOOOXOOOOXXXXXXXOO
