OOOOOOOOOOOOOOOOOOOOOOOOOOOOOOOOOOOOOOOOOOOOOOOOOOOOOOOOOOOOOOOOOOOOOOOOOOOOOOOOOOOOOOOO
OOOOOOOOOOOOOOOOOOOOOOOOOOOOOOOOOOOOOOOOOOOOOOOOOOOOOOOOOOOOOOOOOOOOOOOOOOOOOOOOOOOOOOOO
OOOOOOOOOOOOOOOOOOOOOOOOOOOOOOOOOOOOOOOOOOOOOOOOOOOOOOOOOOOOOOOOOOOOOOOOOOOOOOOOOOOOOOOO
OXXOOOOXXXOOOOOOOOOXXXOOOOOOOOOOOOOOOOOOOOOOOOOOOOOOOOOOOOOOOOOOOOOOOOXOOOOOOOOOOOOOOOOO
OXXOPOOOOOOOOOOOOOOOOOOOOOOOOXXXOOOOOOOOOOOOOOOOOOOOOOOOOOOOOOOOOOOOOOOOOOOOOOOOOOOOOOOO
OXXXXOOOOOOXXOOOOOOOOOOXXOOOOOOOOOOOOOOOOOOOOOOOOOOOOOOOOOOOOOOOOOOOXOOOOOOOOOOOOOOOOOOO
OXXXXOOOOOOXXOOOOOOOOOOOOOOOOOOOOOOOOOOXXXXOOOOOOOOOOOOOOOOOOOOOOOOOOOOOOOOOOOOOOOOOVVOO
OOOOOOXXOOOXXXXOOOOXXOOXXOOOOOXXXXOOOOOOOOOOOOXOOOOOXXXXXXOOOXOOOXOOOOOOOOOOOOOOOXXXXXXO
OOOOOOXXOOOXXXXOOOOXXOOXXOOOOOXXXXOOOOOOOOOOOOXOOOOXXXXXXXOOOXOOOXOOOOOOOOOXXXOOOXXXXXXO
XXXXXXXXOOXXXXXXOOXXXOXXXXOOOOXXXXOOOOOOOOOOOOXOOOOXXXXXXXOOOXOOOXOOOOOOXOOOOOOOOXXXXXXO
XXXXXXXXOOXXXXXXOOXXXOXXXXOOOOXXXXOOOOOOOOOOOOXOOOOXXXXXXXOOOXOOOXOOOOOOOOOOOOOOOXXXXXXO