OOOOOOOOOOOOOOOOOOOOOOOOOOOOOOOOOOOOOOOOOOOOOOOOOOOOOOOOOOOOOOOOOOOOOOOOOOOOOOOOOOOOOOOO
OOOOOOOOOOOOOOOOOOOOOOOOOOOOOOOOOOOOOOOOOOOOOOOOOOOOOOOOOOOOOOOOOOOOOOOOOOOOOOOOOOOOOOOO
OOOOOXOOAOOXOOOOOOXOEOXOOOOOOOOOOOOOOOOOOOOOOOOOOOOOOOOOOOOOOOOOOOOOOOOOOOOOOOOOOOOOOOOO
OXXOOOOXXXOOOOOOOOOXXXOOOOOOOOOOOOOOOOOOOOOOOOOOOOOOOOOOOOOOOOOOOOOOOOXOOOOOOOOOOOOOOOOO
OXXOPOOOOOOOOOOOOOOOOOOOOOOOOXXXOOOOOOOOOOOOOOOOOOOOOOOOOOOOOOOOOOOOOOOOOOOOOOOOOOOOOOOO
OXXXXOOOOOOXXOOOOOOOOOOXXOOOOOOOOOOOOOXOEOOXOOOOOOOOOOOOOOOOOOOOOOOOXOOOOOOOOOOOOOOOOOOO
OXXXXOOOOOOXXOSOOOOAOOOOOOOOOXOOEOXOOOOXXXXOOOOOOOOXOOSEOOXOOOOOOOOOOOOOOOOOOOOOXEOEOSOX
OOOOOOXXOOOXXXXOOOOXXOOXXOOOOOXXXXOOOOOOOOOOOOXOOOOOXXXXXXOOOXOOOXOOOOOOOOOAOOOOOXXXXXXO
XEOOEOXXOOOXXXXOOOOXXOOXXOOOOOXXXXOOOOOOOOOOOOXOOOOXXXXXXXOOOXOOOXOOOOOOOOOXXXOOOXXXXXXO
XXXXXXXXOOXXXXXXOOXXXOXXXXOOOOXXXXOOOOOOOOOOOOXOOOOXXXXXXXOOOXOOOXOOOOOOXOOOOOOOOXXXXXXO
XXXXXXXXOOXXXXXXOOXXXOXXXXOOOOXXXXOOOOOOOOOOOOXOOOOXXXXXXXOOOXOOOXOOOOOOOOOOOOOOOXXXXXXO
