OOOOOOOOOOOOOOOOOOOOOOOOOOOOOOOOOOOOOOOOOOOOOOOOOOOOOOOOOOOOOOOOOOOOOOOOOOOOOOOOOOOOOOOO
OOOOOOOOOOOOOOOOOOOOOOOOOOOOOOOOOOOOOOOOOOOOOOOOOOOOOOOOOOOOOOOOOOOOOOOOOOOOOOOOOOOOOOOO
OOOOOOOOOOOOOOOOOOOOOOOOOOOOOOOOOOOOOOOOOOOOOOOOOOOOOOOOOOOOOOOOOOOOOOOOOOOOOOOOOOOOOOOO
OXXOOOOXXXOOOOOOOOOXXXOOOOOOOOOOOOOOOOOOOOOOOOOOOOOOOOOOOOOOOOOOOOOOOOXOOOOOOOOOOOOOOOOO
OXXOPOOOOOOOOOOOOOOOOOOOOOOOOXXXOOOOOOOOOOOOOOOOOOOOOOOOOOOOOOOOOOOOOOOOOOOOOOOOOOOOOOOO
OXXXXOOOOOOXXOOOOOOOOOOXXOOOOOOOOOOOOOOOOOOOOOOOOOOOOOOOOOOOOOOOOOOOXOOOOOOOOOOOOOOOOOOO
OXXXXOOOOOOXXOOOOOOOOOOOOOOOOOOOOOOOOOOXXXXOOOOOOOOOOOOOOOOOOOOOOOOOOOOOOOOOOOOOOOOOOOOO
OOOOOOXXOOOXXXXOOOOXXOOXXOOOOOXXXXOOOOOOOOOOOOXOOOOOXXXXXXOOOXOOOXOOOOOOOOOOOOOOOXXXXXXO
OOOOOOXXOOOXXXXOOOOXXOOXXOOOOOXXXXOOOOOOOOOOOOXOOOOXXXXXXXOOOXOOOXOOOOOOOOOXXXOOOXXXXXXO
OXXXXXXXOOXXXXXXOOXXXOXXXXOOOOXXXXOOOOOOOOOOOOXOOOOXXXXXXXOOOXOOOXOOOOOOXOOOOOOOOXXXXXXO
OXXXXXXXOOXXXXXXOOXXXOXXXXOOOOXXXXOOOOOOOOOOOOXOOOOXXXXXXXOOOXOOOXOOOOOOOOOOOOOOOXXXXXXO