OLLOOOOOOOOOOOOOOOOOOOOOOOOOOOOOOOOOOOOOOOOOOOOOOOOOOOOOOOOOOOOOOOOOOOOOOOOOOOOOOOOOOOOOOOOOOOOOOOOOO
OOOOOOOOOOOOOOOOOOOOOOOOOOOOOOOOOOOOOOOOOOOOOOOOOOOOOOOOOOOOOOOOOOOOOOOOOOOOOOOOOOOOOOOOOOOOOOOOOOOOO
OOOOOOOOOOOOOOOOOOOLLOOOOOOOOOOOOOOOOOOOOOOOOOOOOOOOOOOOOOOOOOOOOOOOOOOOOOOOOOOOOOOOOOOOOOOOOOOOOOOOO
OXXOOOOXXXOOOOOOOOOXXXOOLOOOOOOOOOOOOOOOOOOOOOOOOOOOOOOOOOOOOOOOOOOOOOXOOOOOOOOOOOOOOOOOOOOOOOOOOOOOO
OXXOPOOOOOOOLOOOOOOOOOOOOOOOOXXXOOOOOOOOLLOOOOOOOOOOOOOOOOOOOOOOOOOOOOOOOOOOOOOOOOOOOOOOOOOOOOOOOOOOO
OXXXXOOLOOOXXOOOOOOOOOOXXOOOOOOLOOOOOOOOOOOOOOOOOOOOOOOOOOOOOOOOOOOOXOOOOOOOOOOOOOLOOOOOOOOOOOOOOOOOO
OXXXXOOOOOOXXOOOOOOOOOOOOOOOOOOOOOOOOOOXXXXOOOOOOOOOOOOOOOOOOOOOOOOOOOOOOOOOOOOOOOOOOOOOOOOOOOOOOOOOO
OOOOOOXXOOOXXXXOOOOXXOOXXOOOOOXXXXOOOOOOOOOOOOXOOOOOXXXXXXOOOXOOOXOOOOOOOOOOOOOOOXXXXXXOOOOOOOOOOOOOO
OOOOOOXXOOOXXXXOOOOXXOOXXOOOOOXXXXOOOOOOOOOOOOXOOOOXXXXXXXOOOXOOOXOOOOOOOOOXXXOOOXXXXXXOOOOOOOOOOOOOO
XXXXXXXXOOXXXXXXOOXXXOXXXXOOOOXXXXOOOOOOOOOOOOXOOOOXXXXXXXOOOXOOOXOOOOOOXOOOOOOOOXXXXXXOOOOOOOOOOOOOO
WWWWWWWWWWWWWWWWWWWWWWWWWWWWWWWWWWWWWWWWWWWWWWWWWWWWWWWWWWWWWWWWWWWWWWWWWWWWWWWWWWWWWWWWWWWWWWWWWWWWW
