OOOOOOOOOOOOOOOOOOOOOOOOOOOOOOOOOOOOOOOOOOOOOOOOOOOOOOOOOOOOOOOOOOOOOOOOOOOOOOOOOOOOOOOO
OOOOOOOOOOOOOOOOOOOOOOOOOOOOOOOOOOOOOOOOOOOOOOOOOOOOOOOOOOOOOOOOOOOOOOOOOOOOOOOOOOOOOOOO
OOOOOOOCCCOOOOOOOOOCCCOOOOOOOOOOOOOOOOOOOOOOOOOOOOOOOOOOOOOOOOOOOOOOOOGOOOOOOOOOOOOOOOOO
OXXOOOOXXXOOOOOOOOOXXXOOOOOOOOOOOOOOOOOOOOOOOOOOOOOOOOOOOOOOOOOOOOOOOOXOOOOOOOOOOOOOOOOO
OXXOPOOOOOOOOOOOOOOOOOOOOOOOOXXXOOOOOOOOOOOOOOOOOOOOOOOOOOOOOOOOOOOOCOOOOOOOOOOOOOOOOOOO
OXXXXOOOOOOXXOOOOOOOOOOXXOOOOOOOOOOOOOOOGGOOOOOOOOOOOOOOOOOOOOOOOOOOXOOOOOOOOOOOOOOOOOOO
OXXXXOOOOOOXXOOOOOOOOOOOOOOOOOOGCOOOOOOXXXXOOOOOOOOOOOOOOOOOOOOOOOOOOOOOOOOOOOOOOOOOOOOO
OOOOOOXXOOOXXXXOOOOXXOOXXOOOOOXXXXOOOOOOOOOOOOXOOOOCXXXXXXOOOXOOOXOOOOOOOOOOOOOOOXXXXXXO
OCGGCOXXOOOXXXXOOOOXXOOXXOOOOOXXXXOOOOOOOOOOOOXOOOOXXXXXXXOOOXOOOXOOOOOOOOOXXXOOOXXXXXXO
XXXXXXXXOOXXXXXXOOXXXOXXXXOOOOXXXXOOOOOOOOOOOOXOOOOXXXXXXXOOOXOOOXOOOOOOXOOOOOOOOXXXXXXO
XXXXXXXXOOXXXXXXOOXXXOXXXXOOOOXXXXOOOOOOOOOOOOXOOOOXXXXXXXOOOXOOOXOOOOOOOOOOOOOOOXXXXXXO